easy
dom - house
kot - cat
pies - dog
książka - book
stół - table
krzesło - chair
okno - window
drzwi - door
auto - car
droga - road
miasto - city
wieś - village
szkoła - school
nauczyciel - teacher
uczeń - student
komputer - computer
telefon - phone
zegar - clock
światło - light
woda - water
chleb - bread
mleko - milk
kawa - coffee
herbata - tea
jabłko - apple
banan - banana
słońce - sun
księżyc - moon
gwiazda - star
niebo - sky
deszcz - rain
śnieg - snow
wiatr - wind
ogień - fire
ziemia - earth
góra - mountain
rzeka - river
jezioro - lake
morze - sea
ocean - ocean
plaża - beach
las - forest
drzewo - tree
kwiat - flower
trawa - grass
liść - leaf
ptak - bird
ryba - fish
koń - horse
krowa - cow
owca - sheep
świnia - pig
kura - chicken
jajko - egg
mięso - meat
warzywo - vegetable
owoc - fruit
cukier - sugar
sól - salt
pieprz - pepper
masło - butter
ser - cheese
talerz - plate
widelec - fork
nóż - knife
łyżka - spoon
kubek - cup
szklanka - glass
butelka - bottle
plecak - backpack
torba - bag
portfel - wallet
pieniądze - money
bank - bank
sklep - shop
kasa - checkout
praca - work
firma - company
biuro - office
szef - boss
kolega - colleague
zadanie - task
projekt - project
urlop - vacation
dom - home
pokój - room
kuchnia - kitchen
łazienka - bathroom
sypialnia - bedroom
łóżko - bed
poduszka - pillow
kołdra - duvet
szafa - wardrobe
półka - shelf
dywan - carpet
lampa - lamp
telewizor - TV
pilot - remote
koc - blanket
ubranie - clothes
spodnie - trousers
koszula - shirt
bluzka - blouse
spódnica - skirt
sukienka - dress
kurtka - jacket
buty - shoes
skarpetki - socks
rękawiczki - gloves
czapka - hat
szalik - scarf
zegarek - watch
pierścionek - ring
naszyjnik - necklace
bransoletka - bracelet
okulary - glasses
okulary przeciwsłoneczne - sunglasses
port - port
statek - ship
łódź - boat
rower - bicycle
samolot - airplane
pociąg - train
autobus - bus
tramwaj - tram
metro - subway
lada - counter
apteka - pharmacy
szpital - hospital
lekarz - doctor
pielęgniarka - nurse
pacjent - patient
tabletka - pill
lekarstwo - medicine
ból - pain
gorączka - fever
kaszel - cough
rana - wound
głowa - head
ręka - hand
noga - leg
oko - eye
ucho - ear
nos - nose
usta - mouth
włosy - hair
skóra - skin
serce - heart
mózg - brain
krew - blood
kość - bone
mięsień - muscle
kolano - knee
stopa - foot
palec - finger
paznokieć - nail
plecy - back
brzuch - stomach
gardło - throat
język - tongue
ramię - arm
łokieć - elbow
dłoń - palm
zapięcie - clasp
klucz - key
zamek - lock
dach - roof
ściana - wall
podłoga - floor
sufit - ceiling
schody - stairs
winda - elevator
podwórko - yard
ogród - garden
garaż - garage
piwnica - basement
strych - attic
mapa - map
księgarnia - bookstore
poczta - post office
list - letter
paczka - package
stempe - stamp
koperta - envelope
telewizja - television
radio - radio
gazeta - newspaper
czasopismo - magazine
muzyka - music
piosenka - song
film - movie
serial - series
kultura - culture
sztuka - art
obraz - painting
rzeźba - sculpture
teatr - theatre
kino - cinema
muzeum - museum
galeria - gallery
sport - sport
piłka - ball
piłka nożna - football
koszykówka - basketball
siatkówka - volleyball
tenis - tennis
bieganie - running
pływanie - swimming
jazda - riding
skok - jump
gra - game
zabawa - fun
święto - holiday
urodziny - birthday
impreza - party
prezent - gift
taniec - dance
śmiech - laughter
przyjaciel - friend
rodzina - family
mama - mother
tata - father
siostra - sister
brat - brother
babcia - grandmother
dziadek - grandfather
ciocia - aunt
wujek - uncle
kuzyn - cousin
dziecko - child
niemowlę - baby
dorosły - adult
kobieta - woman
mężczyzna - man
ludzie - people
miłość - love
przyjaźń - friendship
radość - joy
smutek - sadness
złość - anger
strach - fear
zaskoczenie - surprise
wstyd - shame
pewność - confidence
nadzieja - hope
sen - sleep
marzenie - dream
żart - joke
cisza - silence
hałas - noise
prędkość - speed
siła - strength
waga - weight
rozmiar - size
kształt - shape
kolor - color
czerwony - red
zielony - green
niebieski - blue
żółty - yellow
czarny - black
biały - white
szary - grey
brązowy - brown
pomarańczowy - orange
różowy - pink
fioletowy - purple
złoty - gold
srebrny - silver
drogi - expensive
tani - cheap
duży - big
mały - small
szybki - fast
wolny - slow
stary - old
nowy - new
długi - long
krótki - short
łatwy - easy
trudny - difficult
brudny - dirty
czysty - clean
pełny - full
pusty - empty
gorący - hot
zimny - cold
mokry - wet
suchy - dry
gładki - smooth
szorstki - rough
twardy - hard
miękki - soft
wysoki - tall
niski - short
głośny - loud
cichy - quiet
blisko - near
daleko - far
tutaj - here
tam - there
zawsze - always
nigdy - never
czasami - sometimes
często - often
rzadko - rarely
dziś - today
jutro - tomorrow
wczoraj - yesterday
teraz - now
później - later
wcześniej - earlier
godzina - hour
minuta - minute
sekunda - second
tydzień - week
miesiąc - month
rok - year
pora dnia - daytime
rano - morning
południe - noon
popołudnie - afternoon
wieczór - evening
noc - night
poniedziałek - Monday
wtorek - Tuesday
środa - Wednesday
czwartek - Thursday
piątek - Friday
sobota - Saturday
niedziela - Sunday
tak - yes
nie - no
proszę - please
dziękuję - thank you
przepraszam - sorry
cześć - hello
do widzenia - goodbye
dobranoc - goodnight
dobry - good
zły - bad
otwarty - open
zamknięty - closed
włączony - on
wyłączony - off
wejście - entrance
wyjście - exit
prawda - truth
kłamstwo - lie
pomoc - help
problem - problem
rozwiązanie - solution
pytanie - question
odpowiedź - answer
przykład - example
czas - time
świat - world
kraj - country
państwo - state
międzynarodowy - international
lokalny - local
granica - border
flaga - flag
język - language
religia - religion
historia - history
nauka - science
matematyka - math
fizyka - physics
chemia - chemistry
biologia - biology
geografia - geography
dane - data
informacja - information
system - system
program - program
plik - file
folder - folder
internet - internet
strona - website
hasło - password
konto - account
aktualizacja - update
połączenie - connection
sieć - network
błąd - error
sukces - success
ładowanie - loading
graficzny - graphical
tekstowy - text
drukarka - printer
skaner - scanner
aparat - camera
zdjęcie - photo
filmik - video
mikrofon - microphone
głośnik - speaker
przycisk - button
kabel - cable
bateria - battery
ładowarka - charger